name	chip
assignDensity	new
chainSdf	updated
helixSdf	updated
noiseField	updated
pointMapRender	updated
polarCoordField	updated
textSdf2d	updated
torusGridSdf	updated
twirl	new
waveField	updated
waveFn	updated
waveWarp	updated
magnet	updated
customRender	new
texture3dRender	new
enhancedWaveField	new
helixWarp	new
spin	new
twistedRingsSdf	new
